---------------------------------------------------
            |   |       |     |       |       |   |
|-----|---| |-| | |---| | |-| | --- | | --|-| | | |
|     |     |   | |     | |   | | | | |   |     | |
| | | |---| | --| | |---| | |-| | | | |---| |---| |
| | | |     |   | | |   | | |   |   |   |   |     |
| |-| | |-----| | | |-| | | | |---------| |-| |---|
| |   |   |   | | |   | | | | |           |   |   |
| | |-| | |-| | | |-| | | | | | | |-------| |---| |
| |   | | |   | | |   | | |   | | |   |           |
| |-| |-| | |-| |-| |-| | |---| | | |-| |-| |-----|
|   |     |   |         | |     | |     | | |   | |
|-| |-------| |---| |-| | | |---| |-----| | | | | |
|           | |   |   |   |   |   |   |   |   | | |
| |---| |-| | | | |-| |-----| | |-| | | |---| | | |
| | |     | |   | |   |       | |   | |       |   |
| | | |-| | | |-| | |---------| | | | |-----------|
| | | |   | | | |       |     | | | |       |     |
| | | | |-| | | |-| |-| | |-| | | |-------| | |-| |
|   | |   |   |   | |   |   | |   |     |       | |
|---| |-| |-----| |-| |-----| |---| |-| | |-| | |-|
|   |   | |     |     |     | |   |   | |   | |   |
| | |---| | |-| |-| |-----| | |-| |---| |-| | |-| |
| |   |   | |   |   |           | |         |   | |
| |-| | |-| | |-| |-| |-----| | | | |-------| | |-|
| |   | | | |     |     |     |   | |   |     |   |
| | |-| | | |-----| |---| | |-----| |-| | |-----| |
| |     |   |     | |   | | |     |     |   |   | |
| |---------| | |-| | | | |-| |-| | |-------| | | |
| |     |   | | |   | | | |   |   |     |     |   |
| | |-| | | | | | |---| | | |-| |-------| |---| |-|
|   |   | | | | |     | |   |   |         | |     |
|---| | | | | | | |-| | |---| |-| |-------| | |---|
|   | | | | | |   |   | |   | |   |   |   | | |   |
| | | | | | | |-| | |-| | | | | |-| | | | | | | | |
| | | | | | |   | |   | | |   | |   |   |   |   | |
| |-| | |-| |-| |---| | |-----| | |-| |---| |---| |
| |   |   | | | |   | |     |   |   |     | |     |
| | | |-| | | | | | | |-| | | |---| |---| |-| |---|
|   |   |   |   | |       | | |     |       |   | |
|-----| |---| |-| |-| |---| | | |-------| | | | | |
|     |       |   |   |     | |     |     |   | | |
| |-| |-------| |-| |-------| | |-| | |-------| | |
|   |   |       |   |       | | |   |         |   |
|-| |-| | |-----| |-| |---| | | | |---------| |-| |
|     | | |       |   |   |   | |   |     |   |   |
| | | |-| | |-----| |-| | |-------| | |-| | |---| |
| | |     | |       | | |   |   | | |   |   |   | |
| |-------| | |---| | | | |-| | | | |-| |---| | | |
|         |   |     |   |     |     |   |     |   |
|-------------------------------------------------|